ox	ğŸ‚	True
amateur	ğŸ‘©â€ğŸ¨	True
allegiance	ğŸ‡®ğŸ‡¹	True
hungry	ğŸ³	True
nurturersÂ 	ğŸ§â€â™€ï¸	True
religion	â›©	True
allegiance	ğŸ‡ºğŸ‡¾	True
cute	ğŸ¦¤	True
healing	ğŸ‘©â€ğŸ¦²	True
proud	ğŸ‘©â€ğŸ‘§â€ğŸ‘¦	True
chicken	ğŸ”	True
extinct	ğŸ¦¤	True
holidays	ğŸ·	True
directions	â¬‡	True
cactus	ğŸŒµ	True
flying	ğŸ	True
opponent	ğŸ¤¾â€â™‚ï¸	True
game	ğŸ¥ˆ	True
sex	ğŸ‘º	True
lake	â›°	True